xxxxxxxxxxxxxxxxxxx
x1********k******Bx
xkOkOkOkOkO*OkOkOkx
xk*k*kk*kkkkk*kk**x
xkOkOkOkOkO*O*O*O*x
xkkkkk*k*kk*k*kkk*x
xkO*OkOkOkO*O*OkO*x
xkkkk***kk*kkk*kkkx
x*O*O*OkO*OkOkOkO*x
xk*k*kkk*k*kk*k**kx
x*OkO*O*OkOkOkOkO*x
xB*****kk********2x
xxxxxxxxxxxxxxxxxxx
